Face	KEYWORD1
LEDMatrix	KEYWORD1
happy_standby	KEYWORD2
bounce	KEYWORD2
angry_transition	KEYWORD2
angry_standby	KEYWORD2
eyeColor	KEYWORD2
mouthColor	KEYWORD2
angry_transition_reverse	KEYWORD2
angry_standby	KEYWORD2
loading	KEYWORD2
startup	KEYWORD2
surprise	KEYWORD2
surprise_reverse	KEYWORD2
set_eyeColor	KEYWORD2
set_mouthColor	KEYWORD2
set_eyebrowColor	KEYWORD2
mapLEDXY	KEYWORD2
clearLEDs	KEYWORD2
displayFrame	KEYWORD2
